10
.oo...o..o
..........
..ooo.....
..o.....o.
..........
.......o..
..........
.o........
....o...o.
......o...
